khaṇḍena gopasya siṃhasya ca niveśanaṃ kṛtam | siṃhasya krīḍato ramamāṇasya paricārayato duhitā jātā |

tasyāpi vistareṇa jātimahaṃ kṛtvā celeti nāmadheyaṃ vyavasthāpitam |sā naimittikena dṛṣṭvā vyākṛtā putraṃ janayiṣyati | s
a pitaraṃ jīvitād vyaparopya svayam eva paṭṭaṃ baddhvā rājyaṃ kārayiṣyatīti |

bhūyo ’sya krīḍato ramamāṇasya paricārayato duhitā jātā | tasya api vistareṇa jātimahaṃ kṛtvopaceleti nāmadheyaṃ vyavasth
āpitam |sāpi naimittikena vyākṛtā putraṃ janayiṣyati lakṣaṇasaṃpūrṇam iti |

gopo vyāḍo vikrānto vaiśālakānāṃ licchavīnām udyānāni vināśayati |udyānapālair ucyate | vaiśālakā licchavayo vyāḍā vikrān
tāḥ | mā teṣām udyānāni vināśayeti |

sa nivāryamāṇo ’pi na saṃtiṣṭhate | udyānapālaiḥ khaṇḍasyārocitam | putras te vaiśālakānāṃ licchavīnām udyānāni vināśayat
i | nivārayainam | licchavayo vyāḍā vikrāntā māsyānarthaṃ kariṣyanti |

sa tenāhūyoktaḥ | putra vaiśālakā licchavayo vyāḍā vikrāntā mā teṣām udyānāni vināśaya mā te anarthaṃ kariṣyantīti |

sa kathayati | tāta eṣām udyānāni santi asmākaṃ tu na santi |

sa kathayti | putra udyānasyārthāya gaṇaṃ (MSV II 9) vijñāpayāmīti |

tena gaṇo vijñapto mama putrayor udyānaṃ nāsti | tad arhaṃ mama udyāne prasādaṃ kartum iti |

tais tābhyāṃ jīrṇodyānaṃ dattam | tasmin mahāśālavṛkṣaḥ |tatraikena bhagavataḥ pratimā kāritā | dvitīyena vihāraḥ pratiṣṭ
hāpitaḥ |tathā sthavirair api sūtrānte upanibaddhaṃ buddho bhagavān vaiśālyāṃ viharati gopasiṃhaśālavane iti |

gopaḥ akriyāsahasrāṇi karoti | licchavayo ’vadhyāyanti kṣipanti vivācayanti |tataḥ khaṇḍenāhūyoktaḥ | putra gaccha tvam a
muka karvaṭaṃ tatra svādhiṣṭhitān karmāntān kāraya | tiṣṭha mā gaṇaprakopo bhaviṣyatīti |

sa tatra gatvā svādhiṣṭhitān karmāntān kārayitum ārabdhaḥ |yāvad apareṇa samayena vaiśālyāṃ senāpatiḥ kālagataḥ | taiḥ kh
aṇḍo ’grāmātyaḥ senāpatye sthāpitaḥ |so ’pi kaṃcit kālaṃ dharmeṇa senāpatyaṃ kārayitvā kālagataḥ |vaiśālako gaṇaḥ saṃnip
atitaḥ | kaṃ senāpatiṃ sthāpayāma iti |

tatra eke kathayanti | khaṇḍenāgrāmātyena gaṇaḥ paripālitaḥ | tasyaiva putraṃ sthāpayāma iti |

apare kathayanti | tasya putro gopo vyāḍo vikrāntaḥ |yady asau senāpatye sthāpyate niyataṃ gaṇasya bhedaṃ kariṣyatiyas tu
tasya bhrātā siṃhaḥ sa sūrataḥ (241v1) sukhasaṃvāsaḥ śaknoti gaṇasya cittam ārāgayitum |yadi gaṇasyābhirucitaṃ taṃ senā
patiṃ sthāpayāma iti |

sarveṣām abhirucitam | te saṃbhūya siṃhasya sakāśaṃ gatāḥ | siṃha senāpatitvaṃ pratīccheti |

sa kathayati | mama (10) jyeṣṭho bhrātā gopas taṃ senāpatiṃ sthāpayateti |

te kathayanti | siṃha na yuṣmākaṃ kulakramāgataṃ senāpatyaṃ yo gaṇasyābhirucitaḥ sa senāpatir bhavati |yadi bhavato nābhi
rucitaṃ vayam anyaṃ senāpatiṃ sthāpayāma iti |

sa saṃlakṣayati | yady asmākaṃ gṛhāt senāpatyam anyatra gamiṣyati naitad yuktam | sarvathā pratīcchāmīti | tenādhyavasita
m |sa tair mahatā satkāreṇa senāpatye pratiṣṭhāpitaḥ |

vaiśālakāḥ pūrvaṃ yasya lekham anupreṣayanti tasya khaṇḍapramukho gaṇa ājñāpayatīti likhanti |yadā siṃhaḥ senāpatiḥ saṃvṛ
ttas tadā siṃhapramukho gaṇa ājñāpayatīti |

yāvad apareṇa samayena yasmin karvaṭake gopaḥ svādhiṣṭhitān karmāntān kārayati tadā karvaṭakaṃ lekho gataḥ | gopenodghāṭy
a vācitaḥ |sa kathayati | bhavantaḥ pūrvaṃ vaiśālako gaṇaḥ khaṇḍapramukho gaṇa ājñāpayatīti likhanti | idānīṃ siṃhapramu
kho gaṇaḥ ājñāpayatīti likhanti | kim asmākaṃ pitā kālagataḥ |te kathayanti | kālagataḥ |

sa saṃjātāmarṣo vaiśālīṃ gatvā kathayati | bhrātaḥ yuktaṃ nāma tava mayi jyeṣṭhatare tiṣṭhati senāpatyaṃ kartum iti |

siṃhena tasya yathāvṛttam ārocitam | sa vaiśālakānāṃ licchavīnāṃ saṃjātāmarṣaḥ saṃlakṣayati |mama vaiśālakair asatkāraḥ p
rayukto gacchāmi rājagṛham iti |tena rajño bimbisārasya dūtapreṣaṇaṃ kṛtam | icchāmi devasya bāhucchāyāyāṃ vastum |tenās
ya likhitam | svāgatam | āgaccheti |sa rājagṛhaṃ gataḥ |tato rājñā bimbisāreṇa agrāmātye sthāpitaḥ |

