uddānam |(265r1)bhinnānāṃ deyapratyaṃśaṃ ṛṣilasya ca cārikām |saṃghasya cīvaraṃ caiva aṣṭau lābhena kārayet ||

śrāvastyāṃ nidānam |

āyuṣmān upālī buddhaṃ bhagavantaṃ pṛcchati | antarvarṣe bhadanta saṃgho bhidyeta | deyo lābho na deyaḥ |

bhagavān āha | kasyacid upālin deyaḥ kasyacin na deyaḥ |kasya deyaḥ | dharmapākṣikasya || 1 || antarvarṣe bhadanta bhikṣu
ḥ śikṣāṃ pratyākhyāya hānāyāvartate | deyo lābho na deyaḥ | kasyacid upālin deyaḥ kasyacin na deyaḥ | kasya deyaḥ | yadb
hūyo ’pi tasya || 2 || antarvarṣe bhadanta bhikṣuḥ kālaṃ kuryāt | deyo lābho na deyaḥ | kasyacid upālin deyaḥ kayacin na
deyaḥ | kasya deyaḥ | yadbhūyo ’pi tasya || 3 ||

anyatamasmin karvaṭake gṛhapatiḥ | tena vihāraḥ kāritaḥ sarvopakaraṇasaṃpannaḥ |āyuṣmāṃś ca śāriputro janapadacārikāṃ car
an taṃ vihāram anuprāptaḥ | tena gṛhapatinā bhojayitvā paṃcabhiḥ paṭakaśatair ācchāditaḥ |sa tāni paṃca paṭakaśatāni tas
minn eva vihāre datvā prakrāntaḥ |yāvat tasya dvau sārdhaṃvihāriṇau ṛṣila ṛṣidattaś ca janapadacārikāṃ carantau tam eva 
karvaṭakam anuprāptau | tāv api tena (MSV II 109) gṛhapatinā bhojayitvā paṃcabhiḥ paṭaśatair ācchāditau |

tau bhikṣubhir ucyete | āyuṣmantau yuvayor upādhyāyena tasya gṛhapateḥ sakāśāt paṃca paṭaśatāni labdhāni | tāny asmābhir 
eva bhājitāni | adhunāpy eṣa lābho ’smākam eva prāpadyate |

tau kathayataḥ | upādhyāyo jñāto mahāpuṇyaḥ | tena kadācid yuṣmākam evānumoditaḥ syāt |

te pratiboḍhum ārabdhāḥ | etat prakaraṇaṃ bhikṣavo bhagavata ārocayanti |

bhagavān āha | aṣṭāv ime bhikṣavo lābhāḥ | katame ’ṣṭau | sīmāhṛto lābhaḥ | kriyāhṛtaḥ | niśrayāhṛtaḥ | saṃghaprajñaptaḥ 
| bhikṣuprajñaptaḥ | vārṣikaḥ | saṃmukhaḥ | pratyādeśaś ca |

sīmāhṛto lābhaḥ katamaḥ | yathāpi tad evāvasatha ekaḥ poṣadhaḥ | tayor vihārayor yo lābhaḥ sa ubhayavihāraprativāsināṃ bh
ikṣūṇām | tan nivāsino bhikṣavaḥ kadācid dhi ekapoṣadhena varṣā upagacchanti | tatra yo lābhaḥ saṃpadyate yam asminn eva
vihāre dattas tasmin nivāsibhir eva bhikṣubhiḥ paribhoktavyaṃ hi | ekapoṣadhatvāt ayam ucyate sīmāhṛto lābhaḥ |

kriyāhṛto lābhaḥ katamaḥ | yathāpi tad bhikṣava idam evaṃrūpaṃ kriyākāraṃ kṛtvā varṣā upagacchanti | amukaṃ kulaṃ yuṣmāka
m | (MSV II 110) amukaṃ kulam asmākam | rathyāvīthīcatvaraśṛṅgāṭakā madhyam iti | te ced brāhmaṇagṛhapatayaḥ (265v1) upa
gatakānām āvāsī upagatakānupagatakān bhikṣūn bhojayitvā upagatakānāṃ lābham anuprayacchanti | upagatakānām eva pānīyam |
lābhaḥ kasya prāpadyate | upagatakānām eva || 1 || upagatakānām āvāsī upagatakānupagatakān bhikṣūn bhojayitvā upagatakā
nāṃ lābham anuprayacchanti | anupagatakānāṃ pānīyam | lābhaḥ kasya prāpadyate | upagatakānām eva || 2 || upagatakānām āv
āsī upagatakānupagatakān bhikṣūn bhojayitvā upagatakānāṃ pānīyam anuprayacchanti | anupagatakānāṃ lābham | lābhaḥ kasya 
prāpadyate | upagatakānām eva || 3 || upagatakānām āvāsī upagatakānupagatakān bhikṣūn bhojayitvānupagatakānāṃ lābham anu
prayacchanti | anupagatakānāṃ pānīyam | lābhaḥ kasya prāpadyate || upagatakānām eva || 4 || upagatakānām āvāsī upagatakā
nupagatakān bhikṣūn bhojayitvā vṛddhānte lābham anuprayacchanti | upagatakānāṃ pānīyam | lābhaḥ kasya prāpadyate | upaga
takānām eva || 5 || upagatakānām āvāsī upagatakānupagatakān bhikṣūn bhojayitvā upagatakānāṃ lābham anuprayacchanti | vṛd
dhānte pānīyam | lābhaḥ kasya prāpadyate | upagatakānām eva || 6 || upagatakānām āvāsī upagatakānupagatakān bhikṣūn bhoj
ayitvā vṛddhānte lābham anuprayacchanti | anupagatakānāṃ pānīyam | lābhaḥ kasya (MSV II 111) prāpadyate | upagatakānām e
va || 7 || upagatakānām āvāsī upagatakānupagatakān bhikṣūn bhojayitvā anupagatakānāṃ lābham anuprayacchanti | vṛddhānte 
pānīyam | lābhaḥ kasya prāpadyate | upagatakānām eva || 8 || upagatakānām āvāsī upagatakānupagatakān bhikṣūn bhojayitvā 
upagatakānupagatakānāṃ lābham anuprayacchanti | vṛddhānte ca pānīyam | lābhaḥ kasya prāpadyate | upagatakānām eva || 9 |
|

yathā upagatakānām āvāsī upagatakānupagatakān bhikṣūn bhojayitveti nava paryāyāḥ | evam anupagatakānām āvāsī upagatakān b
hikṣūn bhojayitveti nava paryāyāḥ |

sacet te brāhmaṇagṛhapatayaḥ rathyāvīthīcatvaraśṛṅgāṭakeṣu upagatakānupagatakān bhikṣūn bhojayitvā upagatakānāṃ lābham an
uprayacchanti | upagatakānām eva pānīyam | lābhaḥ kasya prāpadyate | ubhayor api || 1 || rathyāvīthīcatvaraśṛṅgāṭakeṣu u
pagatakānupagatakān bhikṣūn bhojayitvā upagatakānāṃ lābham anuprayacchanti | anupagatakānāṃ pānīyam | lābhaḥ kasya prāpa
dyate | (266r1 = GBM 6.844) ubhayor api || 2 || rathyāvīthīcatvaraśṛṅgāṭakeṣu upagatakānupagatakān bhikṣūn bhojayitvā an
upagatakānāṃ lābham anuprayacchanti | upagatakānāṃ pānīyam | lābhaḥ kasya prāpadyate | ubhayor api || 3 || rathyāvīthīca
tvaraśṛṅgāṭakeṣu upagatakān bhikṣūn bhojayitvā anupagatakānāṃ lābham anuprayacchanti | anupagatakānāṃ pānīyam | (MSV II 
112) lābhaḥ kasya prāpadyate | ubhayor api || 4 || rathyāvīthīcatvaraśṛṅgāṭakeṣu upagatakānupagatakān bhikṣūn bhojayitvā
vṛddhānte lābham anuprayacchanti | upagatakānāṃ pānīyam | lābhaḥ kasya prāpadyate | ubhayor api || 5 || rathyāvīthīcatv
araśṛṅgāṭakeṣu upagatakānupagatakān bhikṣūn bhojayitvā upagatakānāṃ lābham anuprayacchanti | vṛddhānte pānīyam | lābhaḥ 
kasya prāpadyate | ubhayor api || 6 || rathyāvīthīcatvaraśṛṅgāṭakeṣu upagatakānupagatakān bhikṣūn bhojayitvā vṛddhānte l
ābham anuprayacchanti | anupagatakānāṃ pānīyam | lābhaḥ kasya prāpadyate | ubhayor api || 7 || rathyāvīthīcatvaraśṛṅgāṭa
keṣu upagatakānupagatakān bhikṣūn bhojayitvā anupagatakānāṃ lābham anuprayacchanti | vṛddhānte pānīyam | lābhaḥ kasya pr
āpadyate | ubhayor api || 8 || rathyāvīthīcatvaraśṛṅgāṭakeṣu upagatakānupagatakān bhikṣūn bhojayitvā vṛddhānte upagatakā
nupagatakānāṃ lābham anuprayacchanti | vṛddhānte ca pānīyam | lābhaḥ kasya prāpadyate | ubhayor api || 9 || ayam ucyate 
kriyāhṛto labhabḥ |

niśrayāhṛto lābhaḥ katamaḥ | bhikṣur yaṃ strīpuruṣapaṇḍakam upaniśritya varṣā upagacchati sa yaṃ lābhaṃ dadāti tasyaiva s
aḥ | ayam ucyate niśrayāhṛto lābhaḥ |

saṃghaprajñapto lābhaḥ katamaḥ | yo lābho niyato ’vipaṃcitaḥ | ayam ucyate saṃghaprajñapto lābhaḥ |

(MSV II 113) bhikṣuprajñapto lābhaḥ katamaḥ | yo lābho niyato ’vipaṃcitaḥ | layane maṭhe vā kūṭāgāre vā prajñaptaḥ | tatr
a yo bhikṣuḥ prativasati tasyaiva saḥ | ayam ucyate bhikṣuprajñapto lābhaḥ |

vārṣiko lābhaḥ katamaḥ | yo lābho varṣoṣitasya bhikṣusaṃghasya dāyikaiḥ prajñaptaḥ | ayam ucyate vārṣiko lābhaḥ |

saṃmukhalābhaḥ katamaḥ | yo lābho ’niyato ’vipaṃcitaḥ | ayam ucyate saṃmukhalābhaḥ |

pratyādeśalābhaḥ katamaḥ | yo lābho jātau bodhau dharmacakre parinirvāṇe niryātitaḥ | sacen na śakyate caturmahācaityeṣu 
ekasminn eva mahācaitye deyo nānayatra | ayam ucyate pratyādeśalābhaḥ |

